1111111111111111111
1300000001000000031
1011011101011101101
1000000003000000001
1011010111110101101
1000010001000100001
1111011101011101111
2221010000000101222
1111010110110101111
0000000100010000000
1111010111110101111
1000000001000000001
1011011101011101101
1001000003000001001
1101010111110101011
1000010001000100001
1011111101011111101
1300000000000000031
1111111111111111111
