11111110100111011101001111111
10000010011000000110101000001
10111010001011100110101011101
10111010000010001100001011101
10111010010100111101001011101
10000010001011111001001000001
11111110101010101010101111111
00000000101101111110000000000
11011010011101110011101000001
00001001110010000011111111101
00111011001101011000100101000
11000100011110110111100011010
01110111010111010111110011101
01110000000001001000011110100
10101011011110101100001000110
10110001111100010011110110100
10011111110001111010010000100
10011001011110001101001011001
11100111011100101000101100010
11011000110010111110011111101
11010011000010110111111110111
00000000101000011000100010101
11111110010010111001101011000
10000010001000010111100010100
10111010111001110100111111010
10111010100010111001000101110
10111010001000101100010101111
10000010101011111001111001010
11111110100110010010111111000